######
#S...#
#.##.#
#....#
#...E#
######
